//MAP CONVERTED BY dmm2tgm.py THIS HEADER COMMENT PREVENTS RECONVERSION, DO NOT REMOVE
"a" = (
/obj/item/reagent_containers/glass/waterbottle/relic{
	pixel_x = 5;
	pixel_y = -5
	},
/turf/open/floor/plating,
/area/template_noop)
"b" = (
/obj/item/reagent_containers/glass/waterbottle/relic{
	pixel_x = 7;
	pixel_y = -4
	},
/obj/item/reagent_containers/glass/waterbottle/relic{
	pixel_x = -5;
	pixel_y = -7
	},
/turf/open/floor/plating,
/area/template_noop)
"c" = (
/obj/structure/closet,
/obj/effect/spawner/lootdrop,
/obj/effect/spawner/lootdrop,
/obj/effect/spawner/lootdrop,
/obj/effect/spawner/lootdrop,
/turf/open/floor/plating,
/area/template_noop)
"d" = (
/obj/item/reagent_containers/glass/waterbottle/relic{
	pixel_x = 7;
	pixel_y = -10
	},
/turf/open/floor/plating,
/area/template_noop)
"e" = (
/obj/structure/table,
/obj/item/reagent_containers/glass/waterbottle/relic{
	pixel_x = -2;
	pixel_y = -7
	},
/obj/item/reagent_containers/glass/waterbottle/relic{
	pixel_x = 9;
	pixel_y = -8
	},
/obj/item/reagent_containers/glass/waterbottle/relic{
	pixel_x = -8;
	pixel_y = 9
	},
/obj/item/reagent_containers/glass/waterbottle/relic{
	pixel_x = -10;
	pixel_y = -11
	},
/obj/item/reagent_containers/glass/waterbottle/relic{
	pixel_x = 7;
	pixel_y = 8
	},
/turf/open/floor/plating,
/area/template_noop)
"f" = (
/obj/item/reagent_containers/glass/waterbottle/relic{
	pixel_x = 3;
	pixel_y = 5
	},
/turf/open/floor/plating,
/area/template_noop)
"g" = (
/obj/item/reagent_containers/glass/waterbottle/relic{
	pixel_x = -7;
	pixel_y = -5
	},
/turf/open/floor/plating,
/area/template_noop)
"h" = (
/obj/item/reagent_containers/glass/waterbottle/relic{
	pixel_x = 5;
	pixel_y = -8
	},
/turf/open/floor/plating,
/area/template_noop)
"C" = (
/obj/item/reagent_containers/glass/waterbottle/relic{
	pixel_x = 8;
	pixel_y = 7
	},
/turf/open/floor/plating,
/area/template_noop)

(1,1,1) = {"
a
d
g
"}
(2,1,1) = {"
b
e
C
"}
(3,1,1) = {"
c
f
h
"}
