//MAP CONVERTED BY dmm2tgm.py THIS HEADER COMMENT PREVENTS RECONVERSION, DO NOT REMOVE
"aw" = (
/obj/structure/table,
/obj/item/reagent_containers/glass/bottle/random_virus{
	pixel_x = 3;
	pixel_y = 7
	},
/obj/effect/decal/cleanable/dirt,
/turf/open/floor/plasteel/airless/white,
/area/template_noop)
"dB" = (
/turf/open/floor/plating,
/area/template_noop)
"dC" = (
/obj/effect/spawner/lootdrop/glowstick/lit,
/obj/effect/decal/cleanable/dirt,
/turf/open/floor/plating,
/area/template_noop)
"fe" = (
/obj/structure/table,
/obj/item/reagent_containers/glass/bottle/random_virus{
	pixel_x = 8;
	pixel_y = 10
	},
/obj/item/reagent_containers/food/drinks/bottle/virusfood{
	pixel_y = -5
	},
/obj/effect/decal/cleanable/blood/old,
/turf/open/floor/plating,
/area/template_noop)
"fE" = (
/obj/item/trash/energybar,
/turf/open/floor/plating,
/area/template_noop)
"fZ" = (
/obj/machinery/chem_master,
/turf/open/floor/plating,
/area/template_noop)
"gL" = (
/obj/effect/spawner/lootdrop/glowstick/lit,
/turf/open/floor/plating,
/area/template_noop)
"he" = (
/obj/effect/spawner/lootdrop/grille_or_trash,
/turf/open/floor/plasteel/airless/white,
/area/template_noop)
"iG" = (
/obj/item/trash/can,
/obj/effect/decal/cleanable/blood,
/turf/open/floor/plating,
/area/template_noop)
"lm" = (
/obj/structure/sign/departments/minsky/medical/virology/virology1,
/turf/closed/wall,
/area/template_noop)
"lA" = (
/obj/structure/table,
/obj/effect/spawner/lootdrop/maintenance/seven,
/turf/open/floor/plasteel/airless/white,
/area/template_noop)
"lE" = (
/obj/structure/table,
/obj/item/reagent_containers/glass/bottle/retrovirus{
	pixel_x = 5;
	pixel_y = -4
	},
/turf/open/floor/plating,
/area/template_noop)
"mb" = (
/obj/effect/spawner/lootdrop/grille_or_trash,
/obj/effect/spawner/lootdrop/grille_or_trash,
/turf/open/floor/plating,
/area/template_noop)
"mt" = (
/obj/structure/closet/l3closet/virology,
/obj/item/clothing/suit/bio_suit/virology,
/obj/item/clothing/head/bio_hood/virology,
/obj/item/kitchen/knife,
/turf/open/floor/plating,
/area/template_noop)
"mA" = (
/obj/effect/decal/cleanable/dirt,
/turf/open/floor/plasteel/airless/white,
/area/template_noop)
"nA" = (
/obj/effect/decal/cleanable/blood/old,
/obj/effect/decal/cleanable/blood/gibs/old,
/obj/effect/decal/cleanable/blood,
/turf/open/floor/plating,
/area/template_noop)
"pn" = (
/obj/item/trash/popcorn,
/obj/effect/decal/cleanable/dirt,
/turf/open/floor/plating,
/area/template_noop)
"pF" = (
/obj/item/reagent_containers/food/drinks/bottle/virusfood{
	pixel_x = -11;
	pixel_y = -9
	},
/obj/effect/decal/cleanable/blood/old,
/turf/open/floor/plating,
/area/template_noop)
"pR" = (
/obj/item/reagent_containers/glass/bottle/mutagen{
	pixel_x = 8
	},
/obj/effect/decal/cleanable/dirt,
/turf/open/floor/plating,
/area/template_noop)
"pV" = (
/obj/effect/spawner/lootdrop/glowstick/lit,
/obj/item/reagent_containers/glass/bottle/tuberculosis{
	pixel_x = 3;
	pixel_y = 4
	},
/turf/open/floor/plating,
/area/template_noop)
"qi" = (
/obj/effect/decal/cleanable/blood/gibs/old,
/obj/effect/mapping_helpers/airlock/locked,
/obj/machinery/door/airlock/virology/glass{
	name = "Old Virology Airlock"
	},
/turf/open/floor/plating,
/area/template_noop)
"qB" = (
/obj/effect/mob_spawn/human/corpse/assistant/brainrot_infection,
/obj/effect/decal/cleanable/blood/old,
/turf/open/floor/plasteel/airless/white,
/area/template_noop)
"sE" = (
/mob/living/carbon/monkey,
/turf/open/floor/plating,
/area/template_noop)
"uz" = (
/obj/machinery/computer/pandemic,
/turf/open/floor/plating,
/area/template_noop)
"uC" = (
/obj/item/reagent_containers/glass/bottle/random_virus{
	pixel_x = 5
	},
/obj/effect/decal/cleanable/blood,
/turf/open/floor/plating,
/area/template_noop)
"uG" = (
/obj/effect/decal/cleanable/dirt,
/obj/effect/decal/cleanable/blood/gibs,
/turf/open/floor/plasteel/airless/white,
/area/template_noop)
"xp" = (
/obj/structure/table,
/obj/item/reagent_containers/glass/bottle/random_virus{
	pixel_y = 4
	},
/obj/item/reagent_containers/glass/bottle/random_virus{
	pixel_x = -7;
	pixel_y = -4
	},
/obj/item/reagent_containers/glass/bottle/random_virus{
	pixel_x = 8;
	pixel_y = 11
	},
/turf/open/floor/plating,
/area/template_noop)
"xJ" = (
/obj/item/reagent_containers/glass/bottle/mutagen{
	pixel_x = -1;
	pixel_y = -3
	},
/obj/effect/decal/cleanable/dirt,
/turf/open/floor/plating,
/area/template_noop)
"xK" = (
/obj/structure/closet/l3closet/virology,
/obj/item/clothing/suit/bio_suit/virology,
/obj/item/clothing/head/bio_hood/virology,
/turf/open/floor/plating,
/area/template_noop)
"zV" = (
/obj/item/trash/can/food/beefbroth,
/turf/open/floor/plating,
/area/template_noop)
"Bs" = (
/obj/machinery/chem_dispenser,
/obj/effect/decal/cleanable/dirt,
/turf/open/floor/plating,
/area/template_noop)
"BO" = (
/obj/effect/decal/cleanable/blood/old,
/turf/open/floor/plating,
/area/template_noop)
"Ch" = (
/obj/structure/table,
/obj/item/reagent_containers/glass/bottle/random_virus{
	pixel_x = 6;
	pixel_y = 8
	},
/obj/item/reagent_containers/glass/bottle/brainrot{
	pixel_x = -3;
	pixel_y = -6
	},
/obj/effect/decal/cleanable/dirt,
/turf/open/floor/plating,
/area/template_noop)
"Cq" = (
/obj/item/trash/waffles,
/obj/effect/decal/cleanable/dirt,
/turf/open/floor/plating,
/area/template_noop)
"Dx" = (
/obj/item/reagent_containers/glass/bottle/retrovirus{
	desc = "A small bottle. Contains a heart disease culture in a synthblood medium.";
	name = "Heart Disease culture bottle";
	spawned_disease = /datum/disease/heart_failure
	},
/turf/open/floor/plating,
/area/template_noop)
"DG" = (
/obj/effect/decal/cleanable/blood,
/obj/effect/mapping_helpers/airlock/locked,
/obj/machinery/door/airlock/virology/glass{
	name = "Old Virology Airlock"
	},
/turf/open/floor/plating,
/area/template_noop)
"DH" = (
/obj/effect/decal/cleanable/dirt,
/turf/open/floor/plating,
/area/template_noop)
"EH" = (
/obj/item/reagent_containers/glass/bottle/random_virus{
	pixel_x = 3;
	pixel_y = 5
	},
/turf/open/floor/plating,
/area/template_noop)
"FY" = (
/obj/effect/decal/cleanable/vomit/old,
/obj/effect/decal/cleanable/blood/old,
/obj/effect/decal/cleanable/dirt,
/turf/open/floor/plating,
/area/template_noop)
"Gg" = (
/obj/item/reagent_containers/glass/bottle/mutagen{
	pixel_x = -3;
	pixel_y = 3
	},
/turf/open/floor/plasteel/airless/white,
/area/template_noop)
"Gm" = (
/obj/effect/decal/cleanable/dirt,
/obj/effect/decal/cleanable/blood,
/turf/open/floor/plasteel/airless/white,
/area/template_noop)
"Gn" = (
/obj/structure/table,
/obj/effect/spawner/lootdrop/maintenance/five,
/turf/open/floor/plating,
/area/template_noop)
"Hk" = (
/obj/effect/decal/cleanable/vomit,
/turf/open/floor/plasteel/airless/white,
/area/template_noop)
"Hs" = (
/obj/effect/decal/cleanable/blood,
/turf/open/floor/plasteel/airless/white,
/area/template_noop)
"Ig" = (
/obj/effect/decal/cleanable/blood/old,
/mob/living/carbon/monkey,
/obj/effect/decal/cleanable/dirt,
/turf/open/floor/plating,
/area/template_noop)
"IC" = (
/obj/item/trash/syndi_cakes,
/obj/effect/decal/cleanable/vomit,
/turf/open/floor/plasteel/airless/white,
/area/template_noop)
"Jf" = (
/obj/effect/spawner/lootdrop/donkpockets,
/obj/effect/spawner/lootdrop/donkpockets,
/turf/open/floor/plating,
/area/template_noop)
"Ji" = (
/obj/effect/decal/cleanable/blood/old,
/obj/effect/decal/cleanable/dirt,
/turf/open/floor/plating,
/area/template_noop)
"KP" = (
/obj/item/reagent_containers/glass/bottle/retrovirus{
	desc = "A small bottle. Contains a space retrovirus culture in a synthblood medium.";
	name = "Space Retrovirus culture bottle";
	spawned_disease = /datum/disease/dnaspread
	},
/turf/open/floor/plating,
/area/template_noop)
"LB" = (
/obj/structure/table,
/obj/item/reagent_containers/glass/bottle/random_virus{
	pixel_x = -5
	},
/obj/item/reagent_containers/glass/bottle/random_virus{
	pixel_y = 8
	},
/obj/effect/decal/cleanable/dirt,
/turf/open/floor/plating,
/area/template_noop)
"Mv" = (
/obj/effect/decal/cleanable/vomit/old,
/obj/effect/decal/cleanable/dirt,
/turf/open/floor/plating,
/area/template_noop)
"Nm" = (
/obj/item/reagent_containers/food/drinks/bottle/virusfood{
	pixel_x = 3;
	pixel_y = 4
	},
/obj/effect/decal/cleanable/dirt,
/turf/open/floor/plating,
/area/template_noop)
"No" = (
/obj/effect/spawner/lootdrop/donkpockets,
/turf/open/floor/plasteel/airless/white,
/area/template_noop)
"NA" = (
/turf/closed/wall,
/area/template_noop)
"Oz" = (
/obj/effect/decal/cleanable/dirt,
/obj/effect/decal/cleanable/blood,
/turf/open/floor/plating,
/area/template_noop)
"Po" = (
/obj/item/broken_bottle,
/turf/open/floor/plating,
/area/template_noop)
"Qx" = (
/obj/structure/table,
/obj/item/reagent_containers/glass/bottle/random_virus{
	pixel_x = 9;
	pixel_y = 10
	},
/obj/item/reagent_containers/glass/bottle/random_virus{
	pixel_x = -9;
	pixel_y = 3
	},
/obj/item/reagent_containers/glass/bottle/random_virus{
	pixel_x = 4;
	pixel_y = 6
	},
/obj/item/reagent_containers/glass/bottle/random_virus{
	pixel_x = 7;
	pixel_y = 1
	},
/turf/open/floor/plating,
/area/template_noop)
"QJ" = (
/obj/effect/decal/cleanable/vomit/old,
/obj/effect/mob_spawn/human/corpse/damaged,
/turf/open/floor/plating,
/area/template_noop)
"Rw" = (
/obj/structure/table,
/obj/effect/spawner/lootdrop/maintenance/six,
/turf/open/floor/plasteel/airless/white,
/area/template_noop)
"Sn" = (
/obj/item/trash/sosjerky,
/obj/effect/decal/cleanable/dirt,
/turf/open/floor/plating,
/area/template_noop)
"SM" = (
/turf/open/floor/plasteel/airless/white,
/area/template_noop)
"Ua" = (
/obj/item/reagent_containers/glass/bottle/wizarditis{
	desc = "A small bottle. Contains a sample of some sort of virus, though the bottle's bad and mediocre label is vague on the sample and only says WIZARD CONTAGION.";
	name = "WIZARD CONTAGION culture bottle";
	pixel_x = 4
	},
/obj/effect/decal/cleanable/dirt,
/turf/open/floor/plating,
/area/template_noop)
"Uo" = (
/obj/structure/table,
/obj/item/reagent_containers/glass/bottle/random_virus{
	pixel_x = -11;
	pixel_y = -11
	},
/obj/item/reagent_containers/glass/bottle/random_virus{
	pixel_x = 8;
	pixel_y = -5
	},
/obj/item/reagent_containers/glass/bottle/random_virus{
	pixel_y = 11
	},
/turf/open/floor/plating,
/area/template_noop)
"Ux" = (
/obj/effect/spawner/lootdrop/grille_or_trash,
/turf/open/floor/plating,
/area/template_noop)
"UN" = (
/obj/effect/spawner/lootdrop/maintenance/five,
/obj/effect/decal/cleanable/dirt,
/turf/open/floor/plating,
/area/template_noop)
"XG" = (
/obj/item/broken_bottle,
/obj/effect/decal/cleanable/dirt,
/turf/open/floor/plasteel/airless/white,
/area/template_noop)
"YN" = (
/obj/item/reagent_containers/glass/bottle/pierrot_throat{
	pixel_x = 3;
	pixel_y = -4
	},
/obj/effect/decal/cleanable/dirt,
/turf/open/floor/plasteel/airless/white,
/area/template_noop)
"ZW" = (
/obj/structure/table,
/obj/effect/spawner/lootdrop/maintenance/eight,
/turf/open/floor/plasteel/airless/white,
/area/template_noop)
"ZX" = (
/obj/structure/table,
/obj/item/reagent_containers/glass/bottle/random_virus{
	pixel_x = 5;
	pixel_y = 3
	},
/obj/item/reagent_containers/glass/bottle/random_virus{
	pixel_x = -7;
	pixel_y = -12
	},
/turf/open/floor/plating,
/area/template_noop)

(1,1,1) = {"
Cq
xp
ZX
Qx
lE
LB
Bs
mt
xK
fZ
"}
(2,1,1) = {"
dB
aw
DH
QJ
dB
Ch
UN
Gg
mA
DH
"}
(3,1,1) = {"
mA
Uo
KP
IC
uC
fe
SM
Hk
ZW
lA
"}
(4,1,1) = {"
DH
Nm
mA
EH
zV
DH
DH
Jf
Gn
Rw
"}
(5,1,1) = {"
dB
dC
pF
DH
xJ
mA
Hs
DH
DH
mb
"}
(6,1,1) = {"
Ux
fE
pR
Ux
XG
No
mA
Dx
Sn
Mv
"}
(7,1,1) = {"
Po
dB
BO
gL
YN
uz
Ux
Oz
Ux
pn
"}
(8,1,1) = {"
iG
uG
NA
DG
lm
NA
qi
lm
NA
pV
"}
(9,1,1) = {"
uG
nA
NA
FY
FY
NA
DH
BO
NA
he
"}
(10,1,1) = {"
Gm
qB
NA
Ji
Ig
NA
BO
sE
NA
Ua
"}
