//MAP CONVERTED BY dmm2tgm.py THIS HEADER COMMENT PREVENTS RECONVERSION, DO NOT REMOVE
"br" = (
/obj/structure/window/reinforced/spawner,
/obj/effect/decal/cleanable/blood,
/turf/open/floor/plating,
/area/template_noop)
"cA" = (
/mob/living/carbon/monkey{
	name = "Test Subject H0NK";
	remote_control = 1
	},
/obj/effect/decal/cleanable/vomit/old,
/obj/effect/decal/cleanable/blood/old,
/obj/effect/decal/cleanable/dirt,
/turf/open/floor/plating,
/area/template_noop)
"cF" = (
/mob/living/carbon/monkey{
	name = "Test Subject A0Q";
	remote_control = 1
	},
/obj/effect/decal/cleanable/vomit/old,
/obj/effect/decal/cleanable/blood/gibs/old,
/obj/effect/decal/cleanable/vomit,
/turf/open/floor/plating,
/area/template_noop)
"cN" = (
/obj/effect/decal/cleanable/dirt/dust,
/obj/effect/decal/cleanable/vomit/old,
/obj/effect/decal/cleanable/vomit/old,
/obj/effect/decal/cleanable/blood/old,
/obj/effect/decal/cleanable/blood/gibs,
/turf/open/floor/plating,
/area/template_noop)
"dP" = (
/obj/effect/decal/cleanable/blood/old,
/turf/open/floor/plating,
/area/template_noop)
"fQ" = (
/obj/machinery/door/window/northleft,
/obj/effect/decal/cleanable/dirt/dust,
/obj/effect/decal/cleanable/dirt,
/obj/effect/decal/cleanable/blood/gibs,
/turf/open/floor/plating,
/area/template_noop)
"gJ" = (
/obj/effect/decal/cleanable/dirt/dust,
/obj/effect/decal/cleanable/vomit,
/turf/open/floor/plating,
/area/template_noop)
"hy" = (
/mob/living/carbon/monkey{
	name = "Test Subject O09";
	remote_control = 1
	},
/obj/effect/decal/cleanable/dirt/dust,
/obj/effect/decal/cleanable/blood/old,
/obj/effect/decal/cleanable/blood/gibs/old,
/turf/open/floor/plating,
/area/template_noop)
"hQ" = (
/obj/effect/decal/cleanable/vomit/old,
/obj/effect/decal/cleanable/blood,
/obj/effect/decal/cleanable/blood/gibs,
/turf/open/floor/plating,
/area/template_noop)
"ic" = (
/obj/structure/table,
/obj/item/reagent_containers/glass/bottle/cold{
	pixel_y = 3
	},
/obj/item/reagent_containers/glass/bottle/mutagen{
	pixel_x = -4;
	pixel_y = -3
	},
/obj/item/reagent_containers/glass/bottle/viralbase{
	pixel_x = 11
	},
/obj/item/reagent_containers/pill/lsd{
	pixel_x = -17;
	pixel_y = 4
	},
/obj/item/reagent_containers/pill/lsd{
	pixel_x = 6;
	pixel_y = 10
	},
/obj/effect/decal/cleanable/vomit/old,
/turf/open/floor/plating,
/area/template_noop)
"im" = (
/obj/effect/decal/cleanable/blood,
/obj/effect/decal/cleanable/blood/gibs,
/turf/open/floor/plating,
/area/template_noop)
"iW" = (
/obj/effect/decal/cleanable/dirt/dust,
/obj/effect/decal/cleanable/blood,
/turf/open/floor/plating,
/area/template_noop)
"kq" = (
/obj/effect/decal/cleanable/dirt/dust,
/obj/effect/decal/cleanable/vomit/old,
/obj/effect/decal/cleanable/dirt,
/turf/open/floor/plating,
/area/template_noop)
"lQ" = (
/obj/structure/table,
/obj/item/reagent_containers/food/drinks/soda_cans/canned_laughter{
	pixel_x = 5
	},
/obj/item/reagent_containers/glass/bottle/romerol{
	desc = "A bottle of... what seems to be water? it looks too blue though.";
	name = "a bottle of... water..?";
	pixel_x = -5
	},
/obj/item/reagent_containers/glass/bottle/potassium{
	pixel_x = 5;
	pixel_y = 11
	},
/obj/item/reagent_containers/pill/lsd{
	pixel_x = 4;
	pixel_y = 7
	},
/turf/open/floor/plating,
/area/template_noop)
"mx" = (
/obj/effect/decal/cleanable/dirt/dust,
/obj/effect/decal/cleanable/dirt,
/obj/effect/decal/cleanable/blood/gibs,
/turf/open/floor/plating,
/area/template_noop)
"mA" = (
/obj/item/reagent_containers/glass/waterbottle/relic{
	pixel_x = 6
	},
/obj/item/paper/crumpled{
	info = "Date 46 of May 4056, This marks the end of my MANY.. independent virological and chemical experiments with these monkeys I have found... if anyone is reading this last remaining entry you may have found in these... 'Maint Tunnels' (or as I like to call it Home), I am Hobo Jerry, for the longest time ever since I got kicked off of Nanotrasen's science department for being addicted to 'mindbreaker' GODDAMN IT IT'S CALLED LSD YOU CORPORATE NUTS AT NT SILENCING HISTORY!!! but anyways, I have been working on many of my own independent experiments on monkeys without ANY DUMBASS HELP FROM THE RESEARCH DIRECTOR OR A VIROLOGIST!!! infact I quite independent for myself i managed to capture some monkeys from these 'ere tunnels for my own experiments, so far since I finished experimenting on these Maint Monkeys, I was able to cure them of all their effects and illnesses with one of my special potions! so now since I am done experimenting on them, I guess they are basically free to go and do whatever now, also HUGE NOTE, DON'T DRINK THAT LARGE BOTTLE OF 'WATER' I LEFT THERE, IT'S NOT WATER, VERY MUCH NOT WATER!!!";
	pixel_x = -9
	},
/obj/effect/decal/cleanable/dirt/dust,
/turf/open/floor/plating,
/area/template_noop)
"mE" = (
/turf/open/floor/plating,
/area/template_noop)
"nk" = (
/obj/effect/decal/cleanable/dirt,
/obj/effect/decal/cleanable/blood/gibs,
/turf/open/floor/plating,
/area/template_noop)
"nY" = (
/obj/effect/decal/cleanable/dirt/dust,
/obj/effect/decal/cleanable/dirt/dust,
/obj/effect/decal/cleanable/vomit/old,
/obj/effect/decal/cleanable/blood/gibs/old,
/obj/effect/decal/cleanable/dirt,
/obj/effect/decal/cleanable/blood,
/turf/open/floor/plating,
/area/template_noop)
"ox" = (
/obj/effect/decal/cleanable/dirt/dust,
/obj/effect/decal/cleanable/dirt/dust,
/obj/effect/decal/cleanable/dirt,
/obj/effect/decal/cleanable/blood,
/turf/open/floor/plating,
/area/template_noop)
"oJ" = (
/obj/structure/window/reinforced/spawner/west,
/obj/effect/decal/cleanable/blood,
/turf/open/floor/plating,
/area/template_noop)
"oO" = (
/mob/living/carbon/monkey{
	name = "Test Subject RA45";
	remote_control = 1
	},
/obj/effect/decal/cleanable/blood/gibs,
/turf/open/floor/plating,
/area/template_noop)
"pk" = (
/mob/living/carbon/monkey{
	name = "Test Subject 4AL";
	remote_control = 1
	},
/obj/effect/decal/cleanable/dirt/dust,
/obj/effect/decal/cleanable/blood/gibs/old,
/obj/effect/decal/cleanable/dirt,
/obj/effect/decal/cleanable/blood,
/obj/effect/decal/cleanable/blood,
/obj/effect/decal/cleanable/vomit,
/turf/open/floor/plating,
/area/template_noop)
"py" = (
/mob/living/carbon/monkey{
	name = "Test Subject 001";
	remote_control = 1
	},
/obj/effect/decal/cleanable/blood/old,
/obj/effect/decal/cleanable/blood,
/obj/effect/decal/cleanable/vomit,
/turf/open/floor/plating,
/area/template_noop)
"tF" = (
/obj/effect/decal/cleanable/blood,
/turf/open/floor/plating,
/area/template_noop)
"tG" = (
/obj/effect/decal/cleanable/dirt/dust,
/obj/effect/decal/cleanable/blood/old,
/obj/effect/decal/cleanable/vomit,
/turf/open/floor/plating,
/area/template_noop)
"tJ" = (
/obj/effect/decal/cleanable/dirt,
/obj/effect/decal/cleanable/dirt,
/turf/open/floor/plating,
/area/template_noop)
"tS" = (
/mob/living/carbon/monkey{
	name = "Test Subject M0NK";
	remote_control = 1
	},
/obj/effect/decal/cleanable/dirt/dust,
/obj/effect/decal/cleanable/dirt,
/obj/effect/decal/cleanable/blood,
/obj/effect/decal/cleanable/vomit,
/turf/open/floor/plating,
/area/template_noop)
"uE" = (
/obj/effect/decal/cleanable/dirt/dust,
/obj/effect/decal/cleanable/dirt,
/turf/open/floor/plating,
/area/template_noop)
"vh" = (
/obj/structure/window/reinforced/spawner/east,
/obj/effect/decal/cleanable/dirt/dust,
/obj/effect/decal/cleanable/vomit,
/obj/effect/decal/cleanable/dirt,
/turf/open/floor/plating,
/area/template_noop)
"vy" = (
/obj/structure/window/reinforced/spawner/east,
/obj/effect/decal/cleanable/dirt/dust,
/obj/effect/decal/cleanable/dirt/dust,
/turf/open/floor/plating,
/area/template_noop)
"vL" = (
/obj/structure/window/reinforced/spawner/east,
/obj/effect/decal/cleanable/vomit,
/turf/open/floor/plating,
/area/template_noop)
"yV" = (
/obj/effect/decal/cleanable/blood/gibs,
/turf/open/floor/plating,
/area/template_noop)
"zp" = (
/obj/effect/decal/cleanable/dirt/dust,
/obj/effect/decal/cleanable/blood/gibs/old,
/turf/open/floor/plating,
/area/template_noop)
"Ab" = (
/obj/effect/decal/cleanable/dirt/dust,
/obj/effect/decal/cleanable/dirt/dust,
/obj/effect/decal/cleanable/dirt,
/turf/open/floor/plating,
/area/template_noop)
"Ay" = (
/obj/structure/window/reinforced/spawner/west,
/obj/effect/decal/cleanable/dirt/dust,
/obj/effect/decal/cleanable/dirt,
/turf/open/floor/plating,
/area/template_noop)
"AZ" = (
/mob/living/carbon/monkey{
	name = "Test Subject 002";
	remote_control = 1
	},
/obj/effect/decal/cleanable/blood/gibs/old,
/turf/open/floor/plating,
/area/template_noop)
"Cf" = (
/mob/living/carbon/monkey{
	name = "Test Subject 66S";
	remote_control = 1
	},
/obj/effect/decal/cleanable/blood/gibs/old,
/obj/effect/decal/cleanable/blood/gibs/old,
/obj/effect/decal/cleanable/dirt,
/turf/open/floor/plating,
/area/template_noop)
"Cg" = (
/obj/effect/decal/cleanable/vomit,
/turf/open/floor/plating,
/area/template_noop)
"DT" = (
/mob/living/carbon/monkey{
	name = "Test Subject 9000";
	remote_control = 1
	},
/obj/effect/decal/cleanable/vomit/old,
/obj/effect/decal/cleanable/blood/old,
/obj/effect/decal/cleanable/dirt,
/turf/open/floor/plating,
/area/template_noop)
"Ex" = (
/obj/effect/decal/cleanable/dirt/dust,
/obj/effect/decal/cleanable/dirt/dust,
/obj/effect/decal/cleanable/dirt,
/obj/effect/decal/cleanable/blood,
/obj/effect/decal/cleanable/blood/gibs,
/obj/effect/decal/cleanable/vomit,
/turf/open/floor/plating,
/area/template_noop)
"EF" = (
/obj/effect/decal/cleanable/dirt/dust,
/obj/effect/decal/cleanable/blood,
/obj/effect/decal/cleanable/vomit,
/turf/open/floor/plating,
/area/template_noop)
"GB" = (
/obj/structure/table,
/obj/item/reagent_containers/glass/bottle/fake_gbs{
	pixel_y = 2
	},
/obj/item/reagent_containers/pill/lsd{
	pixel_x = -4;
	pixel_y = 10
	},
/obj/item/reagent_containers/pill/lsd{
	pixel_x = 8;
	pixel_y = 3
	},
/obj/effect/decal/cleanable/dirt/dust,
/obj/effect/decal/cleanable/vomit/old,
/obj/effect/decal/cleanable/dirt,
/turf/open/floor/plating,
/area/template_noop)
"GX" = (
/obj/effect/decal/cleanable/dirt/dust,
/obj/effect/decal/cleanable/blood/old,
/turf/open/floor/plating,
/area/template_noop)
"Hg" = (
/obj/effect/decal/cleanable/dirt/dust,
/obj/effect/decal/cleanable/blood/gibs,
/turf/open/floor/plating,
/area/template_noop)
"Ho" = (
/obj/item/reagent_containers/syringe/bioterror{
	pixel_x = 2;
	pixel_y = -5
	},
/turf/open/floor/plating,
/area/template_noop)
"HM" = (
/obj/effect/decal/cleanable/dirt/dust,
/obj/effect/decal/cleanable/dirt/dust,
/obj/effect/decal/cleanable/vomit,
/obj/effect/decal/cleanable/blood/gibs,
/turf/open/floor/plating,
/area/template_noop)
"HZ" = (
/obj/structure/table,
/obj/item/reagent_containers/glass/bottle/brainrot{
	pixel_x = 3;
	pixel_y = -6
	},
/obj/item/reagent_containers/glass/bottle/frostoil{
	pixel_x = 5;
	pixel_y = 4
	},
/obj/item/reagent_containers/pill/lsd{
	pixel_x = 3;
	pixel_y = 4
	},
/obj/effect/decal/cleanable/dirt/dust,
/obj/effect/decal/cleanable/dirt,
/turf/open/floor/plating,
/area/template_noop)
"JI" = (
/mob/living/carbon/monkey{
	name = "Test Subject 45B";
	remote_control = 1
	},
/obj/effect/decal/cleanable/vomit/old,
/obj/effect/decal/cleanable/blood/gibs,
/turf/open/floor/plating,
/area/template_noop)
"JL" = (
/obj/structure/window/reinforced/spawner,
/obj/effect/decal/cleanable/blood/old,
/obj/effect/decal/cleanable/blood/old,
/turf/open/floor/plating,
/area/template_noop)
"Kj" = (
/obj/effect/decal/cleanable/dirt/dust,
/turf/open/floor/plating,
/area/template_noop)
"Ly" = (
/obj/effect/decal/cleanable/dirt,
/turf/open/floor/plating,
/area/template_noop)
"Mn" = (
/obj/structure/window/reinforced/spawner,
/turf/open/floor/plating,
/area/template_noop)
"MJ" = (
/obj/effect/decal/cleanable/blood/gibs/old,
/obj/effect/decal/cleanable/dirt,
/turf/open/floor/plating,
/area/template_noop)
"Nr" = (
/obj/structure/window/reinforced/spawner/north,
/turf/open/floor/plating,
/area/template_noop)
"NX" = (
/obj/effect/decal/cleanable/blood/gibs/old,
/turf/open/floor/plating,
/area/template_noop)
"OP" = (
/obj/structure/window/reinforced/spawner/west,
/obj/effect/decal/cleanable/dirt/dust,
/turf/open/floor/plating,
/area/template_noop)
"PS" = (
/obj/structure/table,
/obj/item/reagent_containers/glass/bottle/carbon{
	pixel_x = -3;
	pixel_y = 1
	},
/obj/item/reagent_containers/glass/bottle/magnitis{
	pixel_x = 5;
	pixel_y = 3
	},
/obj/item/reagent_containers/glass/bottle/radium{
	pixel_x = 14;
	pixel_y = 10
	},
/obj/item/reagent_containers/pill/lsd{
	pixel_y = 9
	},
/obj/item/reagent_containers/pill/lsd{
	pixel_x = 8
	},
/obj/effect/decal/cleanable/dirt/dust,
/turf/open/floor/plating,
/area/template_noop)
"PZ" = (
/obj/effect/decal/cleanable/blood,
/obj/effect/decal/cleanable/dirt,
/turf/open/floor/plating,
/area/template_noop)
"Qb" = (
/obj/structure/window/reinforced/spawner/east,
/turf/open/floor/plating,
/area/template_noop)
"QI" = (
/mob/living/carbon/monkey{
	name = "Test Subject 508";
	remote_control = 1
	},
/obj/effect/decal/cleanable/dirt/dust,
/obj/effect/decal/cleanable/blood/gibs/old,
/obj/effect/decal/cleanable/blood/gibs/old,
/obj/effect/decal/cleanable/dirt,
/obj/effect/decal/cleanable/blood,
/turf/open/floor/plating,
/area/template_noop)
"QM" = (
/obj/effect/decal/cleanable/dirt/dust,
/obj/effect/decal/cleanable/blood/old,
/obj/effect/decal/cleanable/dirt,
/obj/effect/decal/cleanable/vomit,
/obj/effect/decal/cleanable/blood/gibs,
/turf/open/floor/plating,
/area/template_noop)
"Sk" = (
/mob/living/carbon/monkey{
	name = "Test Subject G00N";
	remote_control = 1
	},
/obj/effect/decal/cleanable/blood/gibs/old,
/turf/open/floor/plating,
/area/template_noop)
"UA" = (
/obj/effect/decal/cleanable/dirt/dust,
/obj/effect/decal/cleanable/vomit,
/obj/effect/decal/cleanable/dirt,
/obj/effect/decal/cleanable/dirt,
/obj/effect/decal/cleanable/vomit,
/turf/open/floor/plating,
/area/template_noop)
"Wz" = (
/obj/structure/window/reinforced/spawner/north,
/obj/effect/decal/cleanable/dirt/dust,
/obj/effect/decal/cleanable/dirt,
/turf/open/floor/plating,
/area/template_noop)
"XL" = (
/obj/structure/window/reinforced/spawner,
/obj/effect/decal/cleanable/blood/old,
/turf/open/floor/plating,
/area/template_noop)
"YH" = (
/obj/effect/decal/cleanable/blood/old,
/obj/effect/decal/cleanable/dirt,
/obj/effect/decal/cleanable/vomit,
/turf/open/floor/plating,
/area/template_noop)
"Zv" = (
/obj/structure/table,
/obj/item/reagent_containers/glass/bottle/fluspanish{
	pixel_x = 4
	},
/obj/item/reagent_containers/glass/bottle/plasma{
	pixel_x = -8;
	pixel_y = -4
	},
/obj/item/reagent_containers/glass/bottle/toxin{
	pixel_x = -4;
	pixel_y = 8
	},
/obj/item/reagent_containers/pill/lsd{
	pixel_x = 7;
	pixel_y = 10
	},
/obj/item/reagent_containers/pill/lsd{
	pixel_x = 2;
	pixel_y = -5
	},
/obj/effect/decal/cleanable/dirt,
/turf/open/floor/plating,
/area/template_noop)

(1,1,1) = {"
PZ
Kj
uE
tF
Ly
MJ
Cg
uE
tF
dP
"}
(2,1,1) = {"
iW
PZ
Cg
mA
lQ
Zv
PS
NX
hQ
YH
"}
(3,1,1) = {"
mx
gJ
zp
Ho
GB
ic
HZ
iW
im
Ly
"}
(4,1,1) = {"
Kj
mx
tG
vy
vL
Qb
vh
uE
yV
Ly
"}
(5,1,1) = {"
dP
mE
JL
hy
oO
JI
kq
Nr
Ly
GX
"}
(6,1,1) = {"
tJ
UA
XL
cA
Ex
QI
DT
fQ
uE
Hg
"}
(7,1,1) = {"
Ly
HM
Mn
py
pk
cF
Cf
Wz
yV
mE
"}
(8,1,1) = {"
nk
ox
br
AZ
tS
Sk
nY
Nr
QM
Kj
"}
(9,1,1) = {"
tJ
cN
EF
OP
Ay
oJ
OP
Ab
gJ
Ly
"}
(10,1,1) = {"
uE
Ly
Ly
gJ
mE
Ab
Kj
iW
mE
Cg
"}
