//MAP CONVERTED BY dmm2tgm.py THIS HEADER COMMENT PREVENTS RECONVERSION, DO NOT REMOVE
"a" = (
/obj/effect/mob_spawn/human/oldsec{
	assignedrole = "Station Staff";
	banType = null;
	desc = "a sleeper containing a Nanotrasen Security Officer outposted for the Maint Tunnels of the station.";
	dir = 4;
	flavour_text = "You have been assigned to this station to protect the interests of the company while keeping the peace between guests and the staff.";
	id_access = "1;2;63;12;32";
	id_access_list = "1;2;63;12;32";
	important_info = "You are a ghost role controlled Security Officer, you are expected to sort of the exact same as a normal sec off does with a main focus on exploring maint and mainaining law in it, you are ABSOLUTELY allowed to rp and interact with the rest of the station crew as long as you don't break any rules or self-antag as a maint sec off.";
	mob_name = "Maintenance Security Officer";
	name = "maintenance security sleeper";
	objectives = "Maintain Law and Order in the Maint Tunnels and the rest of the station if nesscessary";
	req_access = "1;2;63;12;32";
	req_access_txt = "1;2;63;12;32"
	},
/turf/open/floor/plasteel/checker,
/area/template_noop)
"c" = (
/obj/structure/closet/crate,
/obj/effect/spawner/lootdrop/armory_contraband,
/obj/effect/spawner/lootdrop/armory_contraband,
/obj/item/clothing/glasses/hud/security,
/obj/item/clothing/glasses/hud/security,
/obj/effect/spawner/lootdrop/ruinloot/armory,
/obj/item/ammo_box/magazine/pistolm9mm,
/obj/item/ammo_box/magazine/pistolm9mm,
/obj/item/ammo_box/magazine/pistolm9mm,
/obj/item/gun/energy/e_gun/mini,
/obj/item/gun/energy/e_gun/mini,
/turf/open/floor/plasteel/checker,
/area/template_noop)
"d" = (
/turf/open/floor/plasteel/checker,
/area/template_noop)
"f" = (
/obj/item/banner/security,
/obj/machinery/light{
	dir = 4
	},
/turf/open/floor/plasteel/checker,
/area/template_noop)
"l" = (
/obj/effect/decal/cleanable/dirt,
/obj/machinery/light,
/turf/open/floor/plasteel/checker,
/area/template_noop)
"m" = (
/obj/item/storage/backpack/ert/security{
	name = "maintenance security backpack"
	},
/turf/open/floor/plasteel/checker,
/area/template_noop)
"p" = (
/obj/structure/sign/departments/minsky/security/security,
/turf/closed/wall,
/area/template_noop)
"r" = (
/obj/machinery/suit_storage_unit/security,
/turf/open/floor/plasteel/checker,
/area/template_noop)
"s" = (
/obj/item/banner/security,
/obj/machinery/light{
	dir = 8
	},
/turf/open/floor/plasteel/checker,
/area/template_noop)
"u" = (
/obj/effect/mob_spawn/human/oldsec{
	assignedrole = "Station Staff";
	banType = null;
	desc = "a sleeper containing a Nanotrasen Security Officer outposted for the Maint Tunnels of the station.";
	dir = 8;
	flavour_text = "You have been assigned to this station to protect the interests of the company while keeping the peace between guests and the staff.";
	id_access = "1;2;63;12;32";
	id_access_list = "1;2;63;12;32";
	important_info = "You are a ghost role controlled Security Officer, you are expected to sort of the exact same as a normal sec off does with a main focus on exploring maint and mainaining law in it, you are ABSOLUTELY allowed to rp and interact with the rest of the station crew as long as you don't break any rules or self-antag as a maint sec off.";
	mob_name = "Maintenance Security Officer";
	name = "maintenance security sleeper";
	objectives = "Maintain Law and Order in the Maint Tunnels and the rest of the station if nesscessary";
	req_access = "1;2;63;12;32";
	req_access_txt = "1;2;63;12;32"
	},
/turf/open/floor/plasteel/checker,
/area/template_noop)
"w" = (
/mob/living/simple_animal/bot/secbot{
	auto_patrol = 1;
	name = "Officer Tunnelton"
	},
/turf/open/floor/plasteel/checker,
/area/template_noop)
"x" = (
/obj/machinery/vending/security,
/turf/open/floor/plasteel/checker,
/area/template_noop)
"z" = (
/obj/structure/closet/crate,
/obj/effect/spawner/lootdrop/ruinloot/security,
/obj/effect/spawner/lootdrop/ruinloot/security,
/obj/effect/spawner/lootdrop/ruinloot/security,
/obj/effect/spawner/lootdrop/ruinloot/security,
/obj/item/clothing/glasses/hud/security,
/obj/item/clothing/glasses/hud/security,
/obj/item/gun/energy/e_gun/mini,
/obj/item/gun/energy/e_gun/mini,
/obj/item/card/id{
	access_txt = "1;2;63;12;32";
	name = "Maintenance Security Officer ID";
	registered_account = 1;
	req_access = "1;2;63;12;32";
	req_access_txt = "1;2;63;12;32"
	},
/obj/item/card/id{
	access_txt = "1;2;63;12;32";
	name = "Maintenance Security Officer ID";
	registered_account = 1;
	req_access = "1;2;63;12;32";
	req_access_txt = "1;2;63;12;32"
	},
/turf/open/floor/plasteel/checker,
/area/template_noop)
"A" = (
/obj/structure/table,
/obj/machinery/computer/security/wooden_tv{
	pixel_x = 2;
	pixel_y = 7
	},
/turf/open/floor/plasteel/checker,
/area/template_noop)
"B" = (
/obj/effect/landmark/start/depsec,
/turf/open/floor/plasteel/checker,
/area/template_noop)
"D" = (
/obj/structure/table,
/obj/item/clothing/glasses/hud/security/sunglasses/gars/supergars,
/turf/open/floor/plasteel/checker,
/area/template_noop)
"E" = (
/obj/machinery/light,
/turf/open/floor/plasteel/checker,
/area/template_noop)
"H" = (
/obj/machinery/light{
	dir = 1
	},
/turf/open/floor/plasteel/checker,
/area/template_noop)
"J" = (
/obj/machinery/light{
	dir = 8
	},
/turf/open/floor/plasteel/checker,
/area/template_noop)
"L" = (
/mob/living/simple_animal/bot/secbot{
	auto_patrol = 1;
	name = "Officer Maintsky"
	},
/obj/machinery/light{
	dir = 4
	},
/turf/open/floor/plasteel/checker,
/area/template_noop)
"M" = (
/obj/item/banner/security,
/turf/open/floor/plasteel/checker,
/area/template_noop)
"N" = (
/obj/machinery/light{
	dir = 4
	},
/turf/open/floor/plasteel/checker,
/area/template_noop)
"R" = (
/obj/structure/closet/crate,
/obj/effect/spawner/lootdrop/donkpockets,
/obj/effect/spawner/lootdrop/donkpockets,
/obj/effect/spawner/lootdrop/donkpockets,
/obj/effect/spawner/lootdrop/donkpocketsfinlandia,
/obj/effect/spawner/lootdrop/donkpocketsfinlandia,
/obj/machinery/light{
	dir = 1
	},
/turf/open/floor/plasteel/checker,
/area/template_noop)
"U" = (
/obj/structure/closet/crate,
/obj/effect/spawner/lootdrop/armory_contraband,
/obj/effect/spawner/lootdrop/armory_contraband,
/obj/effect/spawner/lootdrop/ruinloot/armory,
/obj/item/ammo_box/magazine/pistolm9mm,
/obj/item/ammo_box/magazine/pistolm9mm,
/obj/item/ammo_box/magazine/pistolm9mm,
/obj/item/gun/energy/e_gun/mini,
/obj/item/gun/energy/e_gun/mini,
/turf/open/floor/plasteel/checker,
/area/template_noop)
"V" = (
/obj/structure/table,
/obj/machinery/microwave{
	pixel_y = 9
	},
/turf/open/floor/plasteel/checker,
/area/template_noop)
"X" = (
/obj/structure/table,
/obj/machinery/recharger,
/turf/open/floor/plasteel/checker,
/area/template_noop)
"Y" = (
/obj/effect/decal/cleanable/dirt,
/turf/open/floor/plasteel/checker,
/area/template_noop)

(1,1,1) = {"
D
s
M
J
r
"}
(2,1,1) = {"
A
d
N
Y
x
"}
(3,1,1) = {"
V
d
p
d
E
"}
(4,1,1) = {"
H
Y
a
m
X
"}
(5,1,1) = {"
d
d
B
d
X
"}
(6,1,1) = {"
d
d
d
d
X
"}
(7,1,1) = {"
c
d
u
m
d
"}
(8,1,1) = {"
U
d
p
d
l
"}
(9,1,1) = {"
R
d
J
d
d
"}
(10,1,1) = {"
z
f
M
L
w
"}
