//MAP CONVERTED BY dmm2tgm.py THIS HEADER COMMENT PREVENTS RECONVERSION, DO NOT REMOVE
"c" = (
/obj/effect/decal/cleanable/dirt,
/mob/living/simple_animal/cockroach,
/mob/living/simple_animal/cockroach,
/mob/living/simple_animal/cockroach,
/mob/living/simple_animal/cockroach,
/turf/open/floor/plasteel,
/area/template_noop)
"f" = (
/obj/effect/decal/cleanable/dirt,
/obj/effect/decal/cleanable/dirt,
/mob/living/simple_animal/cockroach,
/turf/open/floor/plating,
/area/template_noop)
"h" = (
/mob/living/simple_animal/cockroach,
/mob/living/simple_animal/cockroach,
/turf/open/floor/plasteel,
/area/template_noop)
"l" = (
/obj/effect/decal/cleanable/dirt,
/mob/living/simple_animal/cockroach,
/mob/living/simple_animal/cockroach,
/turf/open/floor/plasteel,
/area/template_noop)
"m" = (
/obj/effect/decal/cleanable/dirt,
/mob/living/simple_animal/cockroach,
/turf/open/floor/plating,
/area/template_noop)
"u" = (
/obj/effect/decal/cleanable/dirt,
/obj/structure/closet/secure_closet/security,
/obj/effect/spawner/lootdrop/ruinloot/security,
/obj/effect/spawner/lootdrop/ruinloot/security,
/obj/effect/spawner/lootdrop/ruinloot/security,
/obj/item/clothing/suit/bio_suit/security,
/obj/item/clothing/suit/bio_suit/security,
/obj/item/clothing/head/bio_hood/security,
/obj/item/clothing/head/bio_hood/security,
/turf/open/floor/plasteel,
/area/template_noop)
"x" = (
/mob/living/simple_animal/cockroach,
/turf/open/floor/plasteel,
/area/template_noop)
"y" = (
/obj/effect/decal/cleanable/dirt,
/mob/living/simple_animal/cockroach,
/turf/open/floor/plasteel,
/area/template_noop)
"A" = (
/obj/effect/decal/cleanable/dirt,
/turf/open/floor/plasteel,
/area/template_noop)
"E" = (
/obj/effect/decal/cleanable/dirt,
/mob/living/simple_animal/cockroach,
/mob/living/simple_animal/cockroach,
/mob/living/simple_animal/cockroach,
/mob/living/simple_animal/cockroach,
/mob/living/simple_animal/cockroach,
/obj/effect/decal/cleanable/blood,
/turf/open/floor/plating,
/area/template_noop)
"I" = (
/obj/effect/decal/cleanable/dirt,
/mob/living/simple_animal/cockroach,
/obj/effect/mob_spawn/human/corpse/damaged,
/obj/effect/decal/cleanable/blood,
/turf/open/floor/plasteel,
/area/template_noop)
"M" = (
/obj/effect/decal/cleanable/dirt,
/obj/structure/closet/secure_closet/security,
/obj/effect/spawner/lootdrop/ruinloot/security,
/obj/effect/spawner/lootdrop/ruinloot/security,
/obj/item/clothing/suit/bio_suit/security,
/obj/item/clothing/suit/bio_suit/security,
/obj/item/clothing/head/bio_hood/security,
/obj/item/clothing/head/bio_hood/security,
/turf/open/floor/plating,
/area/template_noop)
"O" = (
/obj/structure/closet/secure_closet/security,
/obj/effect/spawner/lootdrop/ruinloot/security,
/obj/effect/spawner/lootdrop/ruinloot/security,
/obj/effect/spawner/lootdrop/ruinloot/security,
/obj/item/clothing/suit/bio_suit/security,
/obj/item/clothing/suit/bio_suit/security,
/obj/item/clothing/head/bio_hood/security,
/obj/item/clothing/head/bio_hood/security,
/turf/open/floor/plasteel,
/area/template_noop)
"P" = (
/obj/item/ammo_casing/shotgun/beanbag,
/obj/effect/decal/cleanable/blood,
/turf/open/floor/plasteel,
/area/template_noop)
"R" = (
/obj/effect/decal/cleanable/blood/gibs,
/turf/open/floor/plasteel,
/area/template_noop)
"Z" = (
/obj/structure/closet/secure_closet/security,
/obj/effect/spawner/lootdrop/ruinloot/security,
/obj/effect/spawner/lootdrop/ruinloot/security,
/obj/item/clothing/suit/bio_suit/security,
/obj/item/clothing/suit/bio_suit/security,
/obj/item/clothing/head/bio_hood/security,
/obj/item/clothing/head/bio_hood/security,
/turf/open/floor/plasteel,
/area/template_noop)

(1,1,1) = {"
O
A
R
m
"}
(2,1,1) = {"
u
x
I
A
"}
(3,1,1) = {"
y
P
E
l
"}
(4,1,1) = {"
x
c
f
h
"}
(5,1,1) = {"
x
A
Z
M
"}
