//MAP CONVERTED BY dmm2tgm.py THIS HEADER COMMENT PREVENTS RECONVERSION, DO NOT REMOVE
"b" = (
/obj/structure/table/wood,
/obj/item/book/manual/random{
	pixel_x = -5;
	pixel_y = 6
	},
/obj/item/book/manual/random{
	pixel_x = 6;
	pixel_y = 1
	},
/obj/item/reagent_containers/glass/waterbottle/relic{
	pixel_x = -1;
	pixel_y = 1
	},
/obj/item/reagent_containers/glass/waterbottle/relic{
	pixel_x = -7;
	pixel_y = 7
	},
/obj/item/reagent_containers/glass/waterbottle/relic{
	pixel_x = 6;
	pixel_y = 8
	},
/obj/item/flashlight/lamp{
	pixel_x = 4;
	pixel_y = 5
	},
/turf/open/floor/plating/rust,
/area/template_noop)
"c" = (
/obj/machinery/chem_master,
/turf/open/floor/plasteel/grid/steel,
/area/template_noop)
"l" = (
/obj/structure/table/wood,
/obj/item/book/granter/spell/knock{
	pixel_x = 6;
	pixel_y = -3
	},
/obj/item/book/granter/spell/smoke/lesser{
	pixel_x = -4;
	pixel_y = 3
	},
/turf/open/floor/plasteel/grid/steel,
/area/template_noop)
"r" = (
/obj/structure/table/wood,
/obj/item/book/granter/martial/cqc{
	pixel_y = 4
	},
/obj/item/reagent_containers/glass/waterbottle/relic{
	pixel_x = -9;
	pixel_y = 3
	},
/obj/item/reagent_containers/glass/waterbottle/relic{
	pixel_x = -8;
	pixel_y = -12
	},
/obj/item/reagent_containers/glass/waterbottle/relic{
	pixel_x = 7;
	pixel_y = -6
	},
/obj/item/reagent_containers/glass/waterbottle/relic{
	pixel_x = 10;
	pixel_y = 11
	},
/obj/item/reagent_containers/glass/waterbottle/relic{
	pixel_x = -6;
	pixel_y = 7
	},
/turf/open/floor/plasteel/grid/steel,
/area/template_noop)
"B" = (
/obj/item/paper{
	desc = "a note written by the infamous Hobo Jerry, read it carefully otherwise face the consequences of Hobo Jerry unless your Jerry himself..";
	info = "This is my Room if you are reading this DO NOT TAKE ANY OF MY STUFF, thank you!";
	name = "a note from Hobo Jerry"
	},
/turf/open/floor/plasteel/grid/steel,
/area/template_noop)
"M" = (
/obj/structure/bed,
/obj/item/bedsheet/captain,
/obj/effect/decal/cleanable/dirt,
/turf/open/floor/plasteel/grid/steel,
/area/template_noop)
"N" = (
/obj/item/flashlight/lamp/green,
/turf/open/floor/plasteel/grid/steel,
/area/template_noop)
"O" = (
/turf/open/floor/plasteel/grid/steel,
/area/template_noop)
"P" = (
/obj/effect/decal/cleanable/dirt,
/turf/open/floor/plasteel/grid/steel,
/area/template_noop)
"T" = (
/obj/structure/bookcase/random,
/turf/open/floor/plasteel/grid/steel,
/area/template_noop)
"U" = (
/obj/effect/decal/cleanable/dirt,
/obj/effect/landmark/start/randommaint/hobo,
/turf/open/floor/plasteel/grid/steel,
/area/template_noop)
"V" = (
/obj/item/reagent_containers/glass/bottle/random_virus,
/turf/open/floor/plasteel/grid/steel,
/area/template_noop)
"X" = (
/obj/effect/decal/cleanable/dirt,
/turf/open/floor/plating,
/area/template_noop)
"Y" = (
/obj/structure/table/wood,
/obj/item/book/granter/spell/mindswap{
	pixel_y = 4
	},
/obj/item/reagent_containers/glass/waterbottle/relic{
	pixel_x = 9;
	pixel_y = -3
	},
/obj/item/reagent_containers/glass/waterbottle/relic{
	pixel_x = -8;
	pixel_y = 13
	},
/obj/item/reagent_containers/glass/waterbottle/relic{
	pixel_x = 9;
	pixel_y = 8
	},
/turf/open/floor/plating,
/area/template_noop)

(1,1,1) = {"
l
O
P
c
"}
(2,1,1) = {"
b
O
O
P
"}
(3,1,1) = {"
T
B
X
O
"}
(4,1,1) = {"
P
O
N
V
"}
(5,1,1) = {"
M
U
r
Y
"}
