//MAP CONVERTED BY dmm2tgm.py THIS HEADER COMMENT PREVENTS RECONVERSION, DO NOT REMOVE
"a" = (
/obj/effect/turf_decal/tile/yellow/tile_full,
/obj/item/reagent_containers/food/snacks/grown/citrus/lemon,
/turf/open/floor/plating,
/area/template_noop)
"T" = (
/obj/effect/turf_decal/tile/yellow/tile_full,
/turf/open/floor/plating,
/area/template_noop)

(1,1,1) = {"
T
T
T
"}
(2,1,1) = {"
T
T
T
"}
(3,1,1) = {"
T
a
a
"}
(4,1,1) = {"
a
a
T
"}
(5,1,1) = {"
T
a
T
"}
