//MAP CONVERTED BY dmm2tgm.py THIS HEADER COMMENT PREVENTS RECONVERSION, DO NOT REMOVE
"b" = (
/obj/structure/chair/office{
	dir = 8
	},
/obj/machinery/light/broken,
/obj/effect/decal/cleanable/dirt,
/turf/open/floor/plasteel,
/area/template_noop)
"c" = (
/obj/effect/decal/cleanable/dirt,
/obj/item/trash/energybar{
	pixel_y = -5
	},
/turf/open/floor/monotile/steel,
/area/template_noop)
"d" = (
/obj/effect/decal/cleanable/dirt,
/obj/effect/spawner/lootdrop/maintenance/seven{
	pixel_x = 6
	},
/obj/effect/spawner/lootdrop/maintenance/seven{
	pixel_y = -8
	},
/turf/open/floor/monotile/steel,
/area/template_noop)
"e" = (
/obj/structure/chair/office{
	dir = 8
	},
/obj/effect/decal/cleanable/dirt,
/obj/effect/decal/cleanable/dirt,
/obj/item/wallframe/light_fixture{
	pixel_y = 14
	},
/turf/open/floor/plasteel,
/area/template_noop)
"f" = (
/obj/effect/spawner/lootdrop/glowstick/lit,
/obj/effect/decal/cleanable/dirt,
/obj/effect/decal/cleanable/dirt,
/turf/open/floor/monotile/steel,
/area/template_noop)
"g" = (
/obj/effect/decal/cleanable/dirt,
/obj/effect/decal/cleanable/dirt,
/obj/item/storage/pill_bottle/floorpill/full,
/obj/machinery/light/red/directional/east,
/turf/open/floor/plasteel,
/area/template_noop)
"h" = (
/obj/item/light/tube{
	pixel_x = -7;
	pixel_y = 5
	},
/obj/effect/decal/cleanable/dirt,
/turf/open/floor/monotile/steel,
/area/template_noop)
"k" = (
/obj/effect/decal/cleanable/dirt,
/obj/effect/decal/cleanable/dirt,
/obj/effect/decal/cleanable/dirt,
/obj/item/reagent_containers/pill/floorpill{
	pixel_y = -3
	},
/turf/open/floor/monotile/steel,
/area/template_noop)
"l" = (
/obj/effect/spawner/lootdrop/maintenance{
	pixel_x = 3
	},
/obj/effect/decal/cleanable/dirt,
/obj/effect/decal/cleanable/dirt,
/obj/effect/decal/cleanable/dirt,
/turf/open/floor/monotile/steel,
/area/template_noop)
"m" = (
/obj/effect/decal/cleanable/oil,
/obj/effect/decal/cleanable/dirt,
/obj/effect/spawner/lootdrop/pizzaparty,
/turf/open/floor/monotile/steel,
/area/template_noop)
"n" = (
/obj/machinery/light{
	dir = 8
	},
/obj/effect/decal/cleanable/dirt,
/obj/effect/spawner/lootdrop/minor,
/turf/open/floor/plasteel,
/area/template_noop)
"o" = (
/obj/effect/decal/cleanable/oil/slippery,
/obj/effect/decal/cleanable/dirt,
/obj/effect/decal/cleanable/dirt,
/obj/effect/spawner/lootdrop/ruinloot/science{
	pixel_y = 4
	},
/turf/open/floor/monotile/steel,
/area/template_noop)
"q" = (
/obj/structure/chair/office{
	dir = 1;
	pixel_x = 7;
	pixel_y = 4
	},
/obj/effect/decal/cleanable/dirt,
/turf/open/floor/monotile/steel,
/area/template_noop)
"r" = (
/obj/effect/decal/cleanable/dirt,
/obj/effect/decal/cleanable/dirt,
/obj/effect/spawner/lootdrop/maintenance/seven{
	pixel_x = -12;
	pixel_y = 4
	},
/turf/open/floor/monotile/steel,
/area/template_noop)
"s" = (
/obj/effect/decal/cleanable/dirt,
/obj/effect/decal/cleanable/dirt,
/obj/effect/spawner/lootdrop/pizzaparty{
	pixel_x = -6
	},
/turf/open/floor/monotile/steel,
/area/template_noop)
"v" = (
/obj/effect/spawner/lootdrop/maintenance,
/obj/effect/decal/cleanable/dirt,
/turf/open/floor/plasteel,
/area/template_noop)
"w" = (
/obj/effect/decal/cleanable/dirt,
/obj/effect/decal/cleanable/blood/old,
/obj/machinery/light/red/directional/east,
/turf/open/floor/plasteel,
/area/template_noop)
"x" = (
/obj/structure/chair/office{
	dir = 8;
	pixel_x = 6
	},
/obj/effect/decal/cleanable/dirt,
/turf/open/floor/plasteel,
/area/template_noop)
"y" = (
/obj/effect/decal/cleanable/dirt,
/obj/item/trash/candy,
/turf/open/floor/monotile/steel,
/area/template_noop)
"z" = (
/obj/effect/spawner/lootdrop/maintenance,
/obj/effect/decal/cleanable/dirt,
/turf/open/floor/monotile/steel,
/area/template_noop)
"B" = (
/obj/effect/decal/cleanable/dirt,
/obj/effect/spawner/lootdrop/maintenance/six,
/turf/open/floor/monotile/steel,
/area/template_noop)
"C" = (
/obj/structure/chair/office{
	dir = 8
	},
/obj/effect/decal/cleanable/dirt,
/obj/item/storage/pill_bottle/floorpill,
/turf/open/floor/plasteel,
/area/template_noop)
"D" = (
/obj/machinery/light{
	dir = 8
	},
/obj/effect/decal/cleanable/dirt,
/obj/effect/decal/cleanable/dirt,
/obj/item/trash/syndi_cakes{
	pixel_x = 8;
	pixel_y = -5
	},
/turf/open/floor/plasteel,
/area/template_noop)
"E" = (
/obj/structure/chair/office{
	dir = 8
	},
/obj/effect/decal/cleanable/dirt,
/turf/open/floor/plasteel,
/area/template_noop)
"F" = (
/obj/effect/decal/cleanable/oil,
/obj/effect/decal/cleanable/dirt,
/obj/effect/decal/cleanable/dirt,
/obj/effect/decal/cleanable/dirt,
/obj/item/reagent_containers/pill/floorpill{
	pixel_y = 7
	},
/turf/open/floor/plasteel,
/area/template_noop)
"G" = (
/obj/structure/chair/office{
	dir = 8
	},
/obj/machinery/light,
/obj/effect/decal/cleanable/dirt,
/turf/open/floor/plasteel,
/area/template_noop)
"H" = (
/obj/effect/decal/cleanable/dirt,
/obj/effect/decal/cleanable/blood/old,
/obj/item/reagent_containers/glass/waterbottle/relic,
/turf/open/floor/monotile/steel,
/area/template_noop)
"J" = (
/obj/structure/chair/office{
	dir = 8
	},
/obj/effect/decal/cleanable/dirt,
/obj/item/trash/chips{
	pixel_x = 15;
	pixel_y = -7
	},
/obj/item/reagent_containers/glass/waterbottle/relic,
/turf/open/floor/plasteel,
/area/template_noop)
"K" = (
/obj/effect/decal/cleanable/dirt,
/obj/item/card/data/disk{
	pixel_x = -4;
	pixel_y = 6
	},
/turf/open/floor/monotile/steel,
/area/template_noop)
"M" = (
/obj/item/reagent_containers/food/drinks/mug{
	pixel_x = -3;
	pixel_y = 5
	},
/obj/effect/decal/cleanable/dirt,
/obj/effect/decal/cleanable/dirt,
/obj/effect/decal/cleanable/dirt,
/turf/open/floor/monotile/steel,
/area/template_noop)
"N" = (
/obj/item/reagent_containers/food/drinks/mug{
	pixel_x = -5;
	pixel_y = -6
	},
/obj/effect/decal/cleanable/dirt,
/obj/effect/decal/cleanable/dirt,
/obj/effect/spawner/lootdrop/minor{
	pixel_y = 8
	},
/turf/open/floor/monotile/steel,
/area/template_noop)
"O" = (
/obj/effect/decal/cleanable/dirt,
/obj/item/reagent_containers/pill/floorpill{
	pixel_x = 15;
	pixel_y = -5
	},
/turf/open/floor/monotile/steel,
/area/template_noop)
"Q" = (
/obj/effect/decal/cleanable/dirt,
/obj/effect/decal/cleanable/dirt,
/obj/effect/spawner/lootdrop/maintenance/seven{
	pixel_x = -7;
	pixel_y = -5
	},
/turf/open/floor/plasteel,
/area/template_noop)
"R" = (
/obj/effect/decal/cleanable/dirt,
/obj/item/trash/coal{
	pixel_y = -3
	},
/turf/open/floor/monotile/steel,
/area/template_noop)
"T" = (
/obj/machinery/computer{
	dir = 4
	},
/obj/effect/decal/cleanable/dirt,
/obj/effect/decal/cleanable/dirt,
/turf/open/floor/plasteel,
/area/template_noop)
"U" = (
/obj/structure/chair/office{
	dir = 8
	},
/obj/machinery/light{
	dir = 1
	},
/obj/effect/decal/cleanable/dirt,
/obj/effect/spawner/lootdrop/maintenance/six{
	pixel_x = -9;
	pixel_y = 4
	},
/turf/open/floor/plasteel,
/area/template_noop)
"W" = (
/obj/machinery/computer{
	dir = 4
	},
/obj/effect/decal/cleanable/dirt,
/turf/open/floor/plasteel,
/area/template_noop)
"X" = (
/obj/machinery/computer{
	dir = 4
	},
/turf/open/floor/plasteel,
/area/template_noop)
"Y" = (
/obj/structure/chair/office{
	dir = 8
	},
/obj/effect/spawner/lootdrop/maintenance/six{
	pixel_x = -1;
	pixel_y = 5
	},
/obj/effect/spawner/lootdrop/maintenance/three{
	pixel_x = -9;
	pixel_y = 2
	},
/obj/effect/decal/cleanable/dirt,
/turf/open/floor/plasteel,
/area/template_noop)
"Z" = (
/obj/structure/chair/office{
	dir = 8
	},
/obj/effect/decal/cleanable/dirt,
/obj/effect/decal/cleanable/dirt,
/obj/effect/decal/cleanable/dirt,
/obj/effect/decal/cleanable/dirt,
/obj/effect/spawner/lootdrop/maintenance/six{
	pixel_x = 7;
	pixel_y = -6
	},
/obj/effect/spawner/lootdrop/maintenance/six{
	pixel_y = 9
	},
/turf/open/floor/plasteel,
/area/template_noop)

(1,1,1) = {"
D
v
H
y
n
"}
(2,1,1) = {"
T
X
r
f
X
"}
(3,1,1) = {"
C
Y
m
k
x
"}
(4,1,1) = {"
W
T
B
N
X
"}
(5,1,1) = {"
U
Z
c
d
b
"}
(6,1,1) = {"
W
X
h
K
X
"}
(7,1,1) = {"
e
F
l
q
G
"}
(8,1,1) = {"
W
W
O
o
X
"}
(9,1,1) = {"
E
E
M
R
J
"}
(10,1,1) = {"
w
Q
s
z
g
"}
